1111111111
1P000000E1
1000100001
1C00100001
1000010001
1C000000C1
1111111111
